0100000000000000000000000000
0101111111111111111111111110
0100000100000000000000000010
0101110101111111101111111110
0101010101000000101000000010
0101010101011110101011111010
0101010101000010100010000010
0101010101111110101010111110
0101010100000000101010100010
0101010111111111101010101010
0101010000100000001010101010
0101011110111111101010101010
0101000010100000001010101010
0101111010101111111010101010
0100001010101010101010101010
0111101010101010101010101010
0100001010101010101010101010
0111111010101010101110101010
0000001010100010100000101010
0111111011101010111111101110
0000000000001000000000000000
