00000000000000
01011111111110
01000001000000
01011101011110
01010101010000
01010101010110
01010101010000
01010101011110
01010101000000
01010101111110
01010100001000
01111111111110
01010000101010
01011110101010
01000010101010
01111010101010
01000010101010
01111110101010
00000010101010
01111110111010
00000000000000
